LN:Level 1
GD:20
ET:5
ED:5
ER:8
RS:1
PR:5
PO:5
GL:
WWWWWWWWWWWWWWWWWWW
W----P--------R---W
W-WOW-W-W-W-W-W-W-W
W--OOOOO----------W
W-WOW-WOW-W-W-W-W-W
W------O------P---W
W-W-W-W-W-W-W-W-W-W
W--R-----OO-------W
W-W-W-W-W-W-W-W-W-W
W-----OO------R---W
W-W-W-W-WOW-W-W-W-W
W------OOO--------W
W-W-W-W-W-W-W-W-W-W
W------OO---------W
W-W-W-WOW-W-WOW-W-W
W-----P------OOO--W
W-W-W-W-W-W-W-WOW-W
W-----R-------OO--W
WWWWWWWWWWWWWWWWWWW